MAZE 4  5 
  3   0   3   1 
  1   3   2   3 
  0   0   1   0 
  0   4   1   4 
  1   2   2   2 
  3   1   3   2 
  3   2   3   3 
  1   0   1   1 
  0   2   1   2 
  2   1   2   2 
  3   3   3   4 
  0   1   0   2 
