MAZE 5  5 
    1     1     2     1 
    0     1     1     1 
    4     0     4     1 
    3     3     4     3 
    3     1     3     2 
    0     0     0     1 
    1     3     1     4 
    1     2     2     2 
    3     1     4     1 
    2     2     3     2 
    0     3     1     3 
    0     4     1     4 
    2     1     3     1 
    4     3     4     4 
    2     3     2     4 
    2     0     2     1 
